rrrrrrrggggg
rP...PrTT.Pg
tT.#.......g
rP...Pr....g
rrr.rrr....g
gP........Pg
g........r.g
g..........g
g........r.g
g..........g
gP........Pg
gggggggggggg